Alabama - AL -- done
Alaska - AK -- done
Arizona - AZ -- done
Arkansas - AR -- done
California - CA -- done
Colorado - CO -- done
Connecticut - CT -- done
Washington, D.C. - DC -- done
Delaware - DE -- done
Florida - FL -- done
Georgia - GA -- done
Hawaii - HI -- done
Idaho - ID -- done
Illinois - IL -- done
Indiana - IN -- done
Iowa - IA -- done
Kansas - KS -- done
Kentucky - KY -- done
Louisiana - LA -- done
Maine - ME -- done
Maryland - MD -- done
Massachusetts - MA -- done
Michigan - MI -- done
Minnesota - MN -- done
Mississippi - MS -- done
Missouri - MO -- done
Montana - MT -- done
Nebraska - NE -- done
Nevada - NV -- done
New Hampshire - NH -- done
New Jersey - NJ -- done
New Mexico - NM -- done
New York - NY -- done
North Carolina - NC -- done
North Dakota - ND -- done
Ohio - OH -- done
Oklahoma - OK -- done
Oregon - OR -- done
Pennsylvania - PA -- done
Rhode Island - RI -- done
South Carolina - SC -- done
South Dakota - SD -- done
Tennessee - TN -- done
Texas - TX -- done
Utah - UT -- done
Vermont - VT -- done
Virginia - VA -- done
Washington - WA -- done
West Virginia - WV -- done
Wisconsin - WI -- done
Wyoming - WY -- done
